Cello Suite No. 1 in G Major, BWV 1007: I. Prélude	Johann Sebastian Bach
Goldberg Variations, BWV 988: Aria	Johann Sebastian Bach
Overture (Suite) No. 2 in B Minor, BWV 1067: VII. Badinerie	Johann Sebastian Bach
The Well-Tempered Clavier, Book 1, BWV 846-869 / Prelude & Fugue in C Major, BWV 846: I. Prelude	Johann Sebastian Bach
Toccata and Fugue in D Minor	Johann Sebastian Bach
Air on a G String	Johann Sebastian Bach
Toccata and Fugue in D minor, BWV 565: I. Toccata	Johann Sebastian Bach
Siciliano (After "Erbarme dich" from Matthäus-Passion, BWV 244, No. 39)	Johann Sebastian Bach
Chopin: Nocturne No. 20 in C-Sharp Minor, Op. posth.	Frédéric Chopin
Nocturne No. 2 in E-flat major, Op. 9 No. 2	Frédéric Chopin
Waltz No. 19 in A minor, Op. posth.	Frédéric Chopin
Nocturne Op. 9 No. 2	Frédéric Chopin
Nocturne No. 1 in B-flat minor, Op. 9 No. 1	Frédéric Chopin
Ballade No. 1 in G minor, Op. 23	Frédéric Chopin
Nocturne en mi bémol majeur, op. 9 no. 2	Frédéric Chopin
Preludes, Op. 28: No. 4, Largo	Frédéric Chopin
Lacrimosa	Wolfgang Amadeus Mozart
Piano Concerto No. 21 in C Major, K. 467: II. Andante	Wolfgang Amadeus Mozart
Requiem in D Minor, K. 626: Sequence: VI. Lacrimosa dies illa	Wolfgang Amadeus Mozart
Requiem, K. 626: Lacrimosa	Wolfgang Amadeus Mozart
Piano Sonata No. 16 in C major, K. 545 "Sonata Facile": I. Allegro	Wolfgang Amadeus Mozart
Symphony No. 25 in G Minor, K. 183: I. Allegro con brio	Wolfgang Amadeus Mozart
Serenade in B-flat major, K. 361 "Gran Partita": III. Adagio	Wolfgang Amadeus Mozart
Fantasia in D Minor, K. 397	Wolfgang Amadeus Mozart
Symphony No. 40 in G Minor, K. 550: I. Molto allegro	Wolfgang Amadeus Mozart
Sonata No. 14 "Moonlight" in C-Sharp Minor", Op. 27 No. 2: I. Adagio sostenuto	Ludwig van Beethoven
Bagatelle No. 25 in A minor, WoO 59 "Für Elise"	Ludwig van Beethoven
Symphony No. 5 in C Minor, Op. 67: I. Allegro con brio	Ludwig van Beethoven
String Quartet No. 13 in B-flat major, Op. 130: II. Presto	Ludwig van Beethoven
Symphony No. 7 in A Major, Op. 92: II. Allegretto	Ludwig van Beethoven
Moonlight Sonata 1st Movement	Ludwig van Beethoven
Vivaldi Variation (Arr. for Piano from Concerto for Strings in G Minor, RV 156 by F. Christl)	Antonio Vivaldi
The Four Seasons: Concerto No. 4 in F Minor, RV 297 "L'inverno" (winter): I. Allegro non molto	Antonio Vivaldi
The Four Seasons: Concerto No. 2 in G Minor, RV 315 "L'estate" (summer): III. Presto	Antonio Vivaldi
Concerto For Strings In G Major, RV 151, "Alla Rustica": I. Presto	Antonio Vivaldi
Cello Concerto in E minor, RV 409: II. Allegro	Antonio Vivaldi
Vivaldi: The Four Seasons, Violin Concerto in G Minor, Op. 8 No. 2, RV 315 "Summer": III. Presto	Antonio Vivaldi
Concerto No. 4 in F minor, Op. 8, RV 297, "L'inverno" (Winter): I. Allegro non molto	Antonio Vivaldi
The Four Seasons - Violin Concerto in F Minor, Op. 8 No. 4, RV 297 "Winter": I. Allegro non molto	Antonio Vivaldi
Winter (from The Four Seasons)	Antonio Vivaldi
Tchaikovsky: Swan Lake, Op. 20, Act 2: No. 10, Scene. Moderato	Pyotr Ilyich Tchaikovsky
Album for the Young, Op. 39: No. 3. Mamma (Maman)	Pyotr Ilyich Tchaikovsky
Six Pieces, Op. 51, TH 143: VI. Valse sentimentale. Tempo di Valse	Pyotr Ilyich Tchaikovsky
Variations on a Rococo Theme, Op. 33, TH 57: Var: VI. Andante	Pyotr Ilyich Tchaikovsky
Swan Lake (Suite), Op. 20a, TH. 219: I. Scene - Swan Theme	Pyotr Ilyich Tchaikovsky
Clair de lune, L. 32	Claude Debussy
Clair de lune	Claude Debussy
Suite Bergamasque, L. 75: III. Clair de lune	Claude Debussy
Rêverie, L. 68	Claude Debussy
Rêverie, L. 68: Rêverie	Claude Debussy
2 Arabesques: Arabesque No. 1	Claude Debussy
Suite Bergamasque, L. 75: III. Clair de lune (Andante très expressif)	Claude Debussy
16 Waltzes, Op. 39 (1867 version): No. 3 in G-Sharp Minor	Johannes Brahms
16 Waltzes, Op. 39: No. 9 in D minor	Johannes Brahms
16 Waltzes, Op. 39: No. 15 in A flat major	Johannes Brahms
21 Hungarian Dances, WoO 1: Hungarian Dance No. 5 in G Minor. Allegro (Orch. Schmeling)	Johannes Brahms
Hungarian Dance No. 5	Johannes Brahms
Ständchen, S. 560 (Trans. from Schwanengesang No. 4, D. 957)	Franz Schubert
Schwanengesang, D.957: No. 4 Serenade	Franz Schubert
Minuet in A Major, D. 334	Franz Schubert
Die Nacht (Arr. for Cello and Guitar by Anja Lechner and Pablo Márquez)	Franz Schubert
Winterreise, Op. 89, D. 911: No. 21, Tauschung (Arr. T. Zimmermann and H. Holl)	Franz Schubert
Ave Maria, D. 839	Franz Schubert
4 Impromptus, Op. 90, D.899: No. 4 in A Flat Major: Allegretto	Franz Schubert
Introduction et variations sur La belle meunière in E Minor, Op. 160, D. 802: III. Var. I	Franz Schubert
Carnival of the Animals: The Swan	Camille Saint-Saëns
The Carnival of the Animals, R. 125: XIII. The Swan (Arr. for Cello and Piano)	Camille Saint-Saëns
Carnival of the Animals, R. 125: The Swan	Camille Saint-Saëns
Le carnaval des animaux, R. 125: 13. Le cygne	Camille Saint-Saëns
Le Cygne	Camille Saint-Saëns
Danse macabre, Op. 40, R.171	Camille Saint-Saëns
Danse Macabre	Camille Saint-Saëns
Piano Concerto No. 2 in C minor, Op. 18: 2. Adagio sostenuto	Sergei Rachmaninoff
12 Songs, Op. 21: V. Lilacs (Transcr. Rachmaninoff for Solo Piano)	Sergei Rachmaninoff
Piano Concerto No. 2 in C minor, Op. 18: I. Moderato	Sergei Rachmaninoff
Rhapsody on a Theme of Paganini, Op. 43: Variation No. 18 Andante cantabile	Sergei Rachmaninoff
Piano Concerto No. 2 in C minor, Op. 18: 1. Moderato	Sergei Rachmaninoff
Piano Concerto No. 2 in C minor, Op. 18: II. Adagio sostenuto	Sergei Rachmaninoff
Prélude in C-sharp minor, Op. 3, No. 2	Sergei Rachmaninoff
Lyric Pieces, Book 1, Op. 12: Arietta	Edvard Grieg
Lyric Pieces, Book 9, Op. 68: Badnlat (Cradle Song)	Edvard Grieg
Peer Gynt Suite No. 1, Op. 46: I. Morning Mood	Edvard Grieg
Lyric Pieces, Book 1, Op. 12: I. Arietta	Edvard Grieg
Lyric Pieces, Book 5, Op. 54: Nocturne	Edvard Grieg
Peer Gynt Suite No. 1, Op. 46: IV. In the Hall of the Mountain King	Edvard Grieg
Peer Gynt, Op. 23: IV. In the Hall of the Mountain King	Edvard Grieg
Lyric Pieces Book I, Op. 12: No. 1 Arietta	Edvard Grieg
Antar (After N. Rimsky-Korsakov): No. 7. Ravel: Allegretto	Maurice Ravel
Miroirs: III. Une Barque sur l'océan	Maurice Ravel
Ravel: Pavane pour une infante défunte, M. 19	Maurice Ravel
Piano Concerto in G major, M. 83: II. Adagio assai	Maurice Ravel
Pavane Pour Une Infante Défunte, M. 19	Maurice Ravel
Jeux d'eau	Maurice Ravel
à la manière de Borodine	Maurice Ravel
Daphnis et Chloe: Part III: Lever du jour	Maurice Ravel
Carnaval, Op. 9: No. 12. Chopin	Robert Schumann
Kinderszenen, Op. 15: 7. Träumerei	Robert Schumann
Kinderszenen, Op. 15: 1. Von fremden Ländern und Menschen	Robert Schumann
Myrthen, Op. 25 - Version for Cello and Piano: XXIV. Du bist wie eine Blume	Robert Schumann
Kinderszenen, Op. 15: No. 1, Von fremden Ländern und Menschen	Robert Schumann
Kinderszenen, Op. 15: Träumerei (Arr. Lewin for Guitar)	Robert Schumann
Serenade for Strings in E Major, Op. 22, B. 52: II. Tempo di valse	Antonín Dvořák
Serenade for Strings in E major, Op. 22, B. 52: IV. Larghetto	Antonín Dvořák
2 Pieces, Op. posth., B. 188: No. 1. Lullaby in G Major	Antonín Dvořák
Songs My Mother Taught Me (from "Gypsy Songs", Op. 55, No. 4)	Antonín Dvořák
Con Te Partirò	Andrea Bocelli
Vivo Per Lei	Andrea Bocelli
Time to Say Goodbye	Andrea Bocelli
Quizás, Quizás, Quizás	Andrea Bocelli
Bésame Mucho	Andrea Bocelli
Vivo Por Ella (feat. KAROL G)	Andrea Bocelli
La Vie En Rose	Andrea Bocelli
Fall On Me	Andrea Bocelli
Piano Concerto No. 2 in F Major, Op. 102: II. Andante	Dmitri Shostakovich
Jazz Suite No. 1: I. Waltz	Dmitri Shostakovich
String Quartet No. 8 in C Minor, Op. 110: 2. Allegro molto	Dmitri Shostakovich
Waltz No. 2	Dmitri Shostakovich
Jazz Suite No. 2: II. Lyric Waltz	Dmitri Shostakovich
Shostakovich / Arr. Atovmyan: Suite from the Gadfly, Op. 97a: VIII. Romance	Dmitri Shostakovich
The Second Waltz, Op. 99a	Dmitri Shostakovich
Piano Concerto No. 2 Op. 102 in F Major: II. Andante	Dmitri Shostakovich
Jazz Suite No. 2: VI. Waltz II	Dmitri Shostakovich
You Raise Me Up	Josh Groban
The Ballad of Sweeney Todd	Josh Groban
Evermore	Josh Groban
Dust and Ashes	Josh Groban
Pierre	Josh Groban
Epiphany	Josh Groban
Johanna (Act 2 Sequence)	Josh Groban
O Holy Night	Josh Groban
A Little Priest	Josh Groban